                                                                                                                                  
                                                                                                                                  
                            ####################                                                                                  
                            #                  #                                                                                  
                            #                  #                                                                                  
                            #         $        #                                                                                  
                            #                  #                                                                                  
                            #                  #                                                                                  
                            ##########D#########                                                                                  
                                     # #                                                                                          
                                     # #                                                                                          
                                     # #                                                                                          
  #####################    ###########D##########                             #####################                               
  #                   #    #                    # ########################    #                   #                               
  #                   ######                    # #                      ######                   #                               
  #         $         D    D          $         # #           $          D    D         $         #                               
  #                   ######                    # #                      ######                   #                               
  #####################    #                    # ########################    #                   #                               
                           ###########D##########                             ##########D##########                               
                                     # #                                               # #                                        
                                     # #                                               # #                                        
     ###############                 # #           #######################       #######D#######                                  
     #             #                 # #           #                     #       #             #                                  
     #             #         #########D#########   #                     #       #             #                                  
     #             ###########                 #####                     #########             #                                  
     #      $      D         D        $        D   D                     D       D      $      #                                  
     #             ###########                 #####                     #########             #                                  
     #             #         #########D#########   #                     #       #             #                                  
     #             #                 # #           #######################       #######D#######                                  
     ###############                 # #                                               # #                                        
                                     # #                                               # #                                        
                              ########D#######                                 #########D#########                                
     ##############           #              #                                 #                 #                                
     #            #           #              #     #######################     #                 #                                
     #            #############              #######                     #######                 #                                
     #            D           D       $      D     D          $          D     D                 #                                
     #s           #############              #######                     #######                 #                                
     ##############           #              #     ###########D###########     #                 #                                
                              ########D#######               # #               #                 #                                
    #############                    # #                     # #               #########D#########                                
    #           #                    # #                     # #                       # #                                        
    #       $   #                    # #                     # #                       # #                                        
    #           #              #######D#######               # #              ##########D##########                               
   ##d###############          #             #         #######D#######        #                   #                               
   #                ############             #         #             ##########                   #                               
   #                D          D      $      #         #      $      D        D                   #                               
   #                ############             #         #             ##########                   #                               
   ##################          #             #         #######D#######        #####################                               
                               ###############               # #                                                                  
                                                             # #                                                                  
                                                             # #                                                                  
                                                   ###########D##########                                                         
                                                   #                    #                                                         
                                                   #                    #                                                         
                                                   #                    #                                                         
                                                   #          $         #                                                         
                                                   #                    #                                                         
                                                   #                    #                                                         
                                                   ######################                                                         
                                                                                                                                  
                                                                                                                                  
                                                                                                                                  
                                                                                                                                  
                                                                                                                                  
                                                                                                                                  
                                                                                                                                  
                                                                                                                                  
                                                                                                                                  
                                                                                                                                  
                                                                                                                                  
                                                                                                                                  
                                                                                                                                  
                                                                                                                                  
                                                                                                                                  
                                                                                                                                  
                                                                                                                                  
                                                                                                                                  
                                                                                                                                  
                                                                                                                                  
                                                                                                                                  
